 1  1  1  1  1  1  1  1  1  1  1  14 14 10 14 9 14  14 14 9  14 9  14 14 10 14 10 9  14 9 
 1  1  1  1  1  1  1  1  1  1  0  9  5  9  3  0  9  0  10 0  10 0  10 9  0  10 0  0  10 0
 1  1  1  1  1  1 49  1  0  3  0  0  0  0  0  4  0  0  0  4  0  0  0  0  0  0  0  0  0  0
 1  1  1  1  1  1  0  0  0  0  10 4  0  0  10 0  0  0  0  0  0  3  9  0  9  0  10 0  0  5
 1  1  1  1  1  1  0  0  5  0  4  0  10 0  5  0  0  10 0  5  0  0  0  0  0  0  0  0  10 0 
 1  1  1  1  1  0  3  0  0  10 0  0  0  0  0  10 0  0  4  0  3  0  0  10 0  5  0  0  0  0
 1  1  1  1  0  0  0  10 0  0  0  3  9  0  0  0  10 0  0  0  0  0  4  0  0  0  4  3  0  0
 1  1  1  0  0  5  0  0  0  14 14 0  0  4  0  0  0  0  0  10 0  3  0  3  0  0  0  0  0  3
 1  0  0  3  0  0  0  4  0  11 14 5  0  0  0  10 0  0  5  0  0  0  0  0  5  10 0  0  4  0
14  0  0  0  0  4  0  0  0  17 0  0  0  9  0  4  0  10 0  0  0  9  5  0  0  0  0  0  0  0
14  10 5  0  5  0  10 0  0  17 0  0  3  0  0  0  0  0  0  0  5  0  0  3  9  0  0  3  0 10
10  0  0  9  0  0  0  0  0  17 10 0  0  0  4  0  0  3  0  0  0  4  0  0  3  0  5  0  0  0
14  14 0  0  0  0  3  0  4  22 18 18 18 18 18 18 18 18 18 18 18 18 19 0  0  0  0  0  0  3
14  9  0  4  0  0  0  0  0  5  0  0  0  0  0  0  0  0  0  0  0  0  17 0  0  0  0  0  0  0
 9  0  0  0  0  10 0  0  0  0  0  0  0  4  0  0  0  3  10 0  5  0  17 0  5  0  0  0  0  0
 0  14 0  0  3  0  5  0  10 0  0  5  0  0  0  5  0  0  0  0  0  0  17 0  0  0  0  0  0  4
14  10 0  5  0  0  0  3  0  0  9  0  0  0  0  0  4  0  4  0  3  0  17 0  3  0  0  0  0  0
14  0  0  0  0  0  0  0  0  0  0  0  5  0  0  0  0  0  0  0  0  3  17 0  0  0  0  0  5  0
 9  3  10 0  0  0  0  0  0  0  4  0  0  14 14 0  0  0  0  9  0  0  17 0  0  4  0  0  0  0
14  0  0  4  0  14 14 0  10 0  0  3  0  15 14 0  3  0  0  0  10 0  17 0  0  0  14 14 0  0
14  0  0  0  0  15 14 0  0  5  0  0  0  17 0  0  0  0  14 14 0  0  17 0  0  0  15 14 0  3
 9  14 5  10 0  17 0  0  0  0  0  3  0  17 10 0  0  0  15 14 3  0  17 0  0  0  17 0  0  0
14  9  0  0  3  22 18 18 18 18 18 18 18 23 18 18 18 18 23 18 24 18 23 18 18 18 20 0  0  0
14  14 0  5  0  0  0  0  0  0  3  0  0  0  0  0  0  0  0  0  17 0  0  0  0  0  0  0  3  0
10  10 0  0  0  0  3  10 5  0  0  5  10 0  0  0  4  0  0  5  17 0  5  0  0  0  0  0  0  0
14  0  3  10 4  10 0  0  0  9  0  0  0  0  5  0  0  14 14 0  17 0  0  0  0  14 14 0  0  0
 9  0  0  4  0  0  0  5  10 0  10 0  0  9  0  5  0  15 14 0  17 0  0  0  0  15 14 10 0  0
14 14  0  0  0  0  10 0  0  0  0  4  0  4  0  0  0  22 18 18 23 18 18 18 18 20 0  0  5  0
14 10  14 0  0  0  5  10 0  5  9  0  9  0  0  9  0  0  0  0  0  0  0  0  0  0  0  0  0  0
14 14  10 10 14 10 9  14 10 14 14 10 14 10 14 14 9  5  9  14 10 14 10 9  10 14 9  9  14 0