1  1  1  1  1  1  1  1  1  1  1  1  1  1  1  1  1  1  1  1  1  1  1  1  1  1  1  1  1  1  1  1  1  1  1  1  1  1  1  1  1  1  1  1  1  1  1  1  1  1  1  1  1  1  1  1  1  1  1  1  1  1  1  1  1  1  1
1  1  1  1  1  1  1  1  1  1  1  1  1  1  1  1  1  1  1  1  1  1  1  1  1  1  1  1  1  1  1  1  1  1  1  1  1  1  1  1  1  1  1  1  1  1  1  1  1  1  1  1  1  1  1  1  1  1  1  1  1  1  1  1  1  1  1
1  1  1  1  1  1  1  1  1  1  1  1  1  1  1  1  1  1  1  1  1  1  1  1  1  1  1  1  1  1  1  1  1  1  1  1  1  1  1  1  1  1  1  1  1  1  1  1  1  1  1  1  1  1  1  1  1  1  1  1  1  1  1  1  1  1  1
1  1  1  1  1  1  1  1  1  1  1  1  1  1  1  1  1  1  1  1  1  1  1  1  1  1  1  1  1  1  1  1  1  1  1  1  1  1  1  1  1  1  1  1  1  1  1  1  1  1  1  1  1  1  1  1  1  1  1  1  1  1  1  1  1  1  1
1  1  1  48 48 48 48 48 48 48 48 48 48 1  1  1  1  1  1  1  48 48 48 48 48 48 48 48 48 48 1  1  1  1  1  1  1  48 48 48 48 48 48 48 48 48 48 1  1  1  1  1  1  1  48 48 48 48 48 48 48 48 48 48 1  1  1
1  1  1  6  6  6  6  6  6  6  6  6  6  1  1  1  1  1  1  1  6 29 29 29  6  6 29 29 29  6  1  1  1  1  1  1  1  53 53 54 54 61 6  60 56 6  55 1  1  1  1  1  1  1  6  6  6  6  6  6  6  6  6  6  1  1  1
1  1  1  6  6  6  6  6  6  6  6  6  6  1  1  1  1  1  1  1  6 25 26 27  6  6 25 26 27  6  1  1  1  1  1  1  1  6  6  6  6  6  6  60 56 6  59 1  1  1  1  1  1  1  6  6  6  6  6  6  6  6  6  6  1  1  1
1  1  1  6  6  6  6  6  6  6  6  6  6  1  1  1  1  1  1  1  6 28 28 28  6  6 28 28 28  6  1  1  1  1  1  1  1  6  6  6  6  6  58 60 56 6  57 1  1  1  1  1  1  1  6  6  6  6  6  6  6  6  6  6  1  1  1
1  1  1  6  6  6  6  6  6  6  6  6  6  1  1  1  1  1  1  1  6 29 29 29  6  6 29 29 29  6  1  1  1  1  1  1  1  6  6  6  6  6  6  60 6  6  58 1  1  1  1  1  1  1  6  6  6  6  6  6  6  6  6  6  1  1  1
1  1  1  6  6  6  6  6  6  6  6  6  6  1  1  1  1  1  1  1  6 25 26 27  6  6 25 26 27  6  1  1  1  1  1  1  1  6  6  6  6  6  6  6  6  6  6  1  1  1  1  1  1  1  6  6  6  6  6  6  6  6  6  6  1  1  1
1  1  1  6  6  6  6  6  6  6  6  6  6  1  1  1  1  1  1  1  6 28 28 28  6  6 28 28 28  6  1  1  1  1  1  1  1  6  6  6  6  6  6  6  6  6  6  1  1  1  1  1  1  1  6  6  6  6  6  6  6  6  6  6  1  1  1
1  1  1  6 29 29 29 29 29 29 29 29  6  1  1  1  1  1  1  1  6 29 29 29  6  6 29 29 29  6  1  1  1  1  1  1  1  6  6  6  6  6  6  6  6  6  6  1  1  1  1  1  1  1  6  6  6  6  6  6  6  6  6  6  1  1  1
1  1  1  6 25 26 26 26 26 26 26 27  6  1  1  1  1  1  1  1  6 25 26 27  6  6 25 26 27  6  1  1  1  1  1  1  1  6  6  6  6  6  6  6  6  6  6  1  1  1  1  1  1  1  6  6  6  6  6  6  6  6  6  6  1  1  1
1  1  1  6 28 28 28 28 28 28 28 28  6  1  1  1  1  1  1  1  6 28 28 28  6  6 28 28 28  6  1  1  1  1  1  1  1  6  6  6  6  6  6  6  6  6  6  1  1  1  1  1  1  1  6  6  6  6  6  6  6  6  6  6  1  1  1
1  1  1  6  6  6  6  6  6  6  6  6  6  1  1  1  1  1  1  1  6  6  6  6  6  6  6  6  6  6  1  1  1  1  1  1  1  6  6  6  6  6  6  6  6  6  6  1  1  1  1  1  1  1  6  6  6  6  6  6  6  6  6  6  1  1  1
1  1  1 12  1  1  1  1  1  1  1  1  1  1  1  1  1  1  1  1 12  1  1  1  1  1  1  1  1  1  1  1  1  1  1  1  1 12  1  1  1  1  1  1  1  1  1  1  1  1  1  1  1  1 12  1  1  1  1  1  1  1  1  1  1  1  1
1  1  1  1  1  1  1  1  1  1  1  1  1  1  1  1  1  1  1  1  1  1  1  1  1  1  1  1  1  1  1  1  1  1  1  1  1  1  1  1  1  1  1  1  1  1  1  1  1  1  1  1  1  1  1  1  1  1  1  1  1  1  1  1  1  1  1
1  1  1  1  1  1  1  1  1  1  1  1  1  1  1  1  1  1  1  1  1  1  1  1  1  1  1  1  1  1  1  1  1  1  1  1  1  1  1  1  1  1  1  1  1  1  1  1  1  1  1  1  1  1  1  1  1  1  1  1  1  1  1  1	1  1  1
1  1  1  1  1  1  1  1  1  1  1  1  1  1  1  1  1  1  1  1  1  1  1  1  1  1  1  1  1  1  1  1  1  1  1  1  1  1  1  1  1  1  1  1  1  1  1  1  1  1  1  1  1  1  1  1  1  1  1  1  1  1  1  1	1  1  1
1  1  1  1  1  1  1  1  1  1  1  1  1  1  1  1  1  1  1  1  1  1  1  1  1  1  1  1  1  1  1  1  1  1  1  1  1  1  1  1  1  1  1  1  1  1  1  1  1  1  1  1  1  1  1  1  1  1  1  1  1  1  1  1  1  1  1
1  1  1  1  1  1  1  1  1  1  1  1  1  1  1  1  1  1  1  1  1  1  1  1  1  1  1  1  1  1  1  1  1  1  1  1  1  1  1  1  1  1  1  1  1  1  1  1  1  1  1  1  1  1  1  1  1  1  1  1  1  1  1  1  1  1  1
1  1  1  1  1  1  1  1  1  1  1  1  1  1  1  1  1  1  1  1  1  1  1  1  1  1  1  1  1  1  1  1  1  1  1  1  1  1  1  1  1  1  1  1  1  1  1  1  1  1  1  1  1  1  1  1  1  1  1  1  1  1  1  1  1  1  1
1  1  1  1  1  1  1  1  1  1  1  1  1  1  1  1  1  1  1  1  1  1  1  1  1  1  1  1  1  1  1  1  1  1  1  1  1  1  1  1  1  1  1  1  1  1  1  1  1  1  1  1  1  1  1  1  1  1  1  1  1  1  1  1  1  1  1
1  1  1  48 48 48 48 48 48 48 48 48 48 1  1  1  1  1  1  1  48 48 48 48 48 48 48 48 48 48 1  1  1  1  1  1  1  48 48 48 48 48 48 48 48 48 48 1  1  1  1  1  1  1  48 48 48 48 48 48 48 48 48 48 1  1  1
1  1  1  6  6  6  6  6  6  6  6  6  6  1  1  1  1  1  1  1  6  6  6  6  6  6  6  6  6  6  1  1  1  1  1  1  1  6  6  6  6  6  6  6  6  6  6  1  1  1  1  1  1  1  6  6  6  6  6  6  6  6  6  6  1  1  1
1  1  1  6  6  6  6  6  6  6  6  6  6  1  1  1  1  1  1  1  6  6  6  6  6  6  6  6  6  6  1  1  1  1  1  1  1  6  6  6  6  6  6  6  6  6  6  1  1  1  1  1  1  1  6  6  6  6  6  6  6  6  6  6  1  1  1
1  1  1  6  6  6  6  6  6  6  6  6  6  1  1  1  1  1  1  1  6  6  6  6  6  6  6  6  6  6  1  1  1  1  1  1  1  6  6  6  6  6  6  6  6  6  6  1  1  1  1  1  1  1  6  6  6  6  6  6  6  6  6  6  1  1  1
1  1  1  6  6  6  6  6  6  6  6  6  6  1  1  1  1  1  1  1  6  6  6  6  6  6  6  6  6  6  1  1  1  1  1  1  1  6  6  6  6  6  6  6  6  6  6  1  1  1  1  1  1  1  6  6  6  6  6  6  6  6  6  6  1  1  1
1  1  1  6  6  6  6  6  6  6  6  6  6  1  1  1  1  1  1  1  6  6  6  6  6  6  6  6  6  6  1  1  1  1  1  1  1  6  6  6  6  6  6  6  6  6  6  1  1  1  1  1  1  1  6  6  6  6  6  6  6  6  6  6  1  1  1
1  1  1  6  6  6  6  6  6  6  6  6  6  1  1  1  1  1  1  1  6  6  6  6  6  6  6  6  6  6  1  1  1  1  1  1  1  6  6  6  6  6  6  6  6  6  6  1  1  1  1  1  1  1  6  6  6  6  6  6  6  6  6  6  1  1  1
1  1  1  6  6  6  6  6  6  6  6  6  6  1  1  1  1  1  1  1  6  6  6  6  6  6  6  6  6  6  1  1  1  1  1  1  1  6  6  6  6  6  6  6  6  6  6  1  1  1  1  1  1  1  6  6  6  6  6  6  6  6  6  6  1  1  1
1  1  1  6  6  6  6  6  6  6  6  6  6  1  1  1  1  1  1  1  6  6  6  6  6  6  6  6  6  6  1  1  1  1  1  1  1  6  6  6  6  6  6  6  6  6  6  1  1  1  1  1  1  1  6  6  6  6  6  6  6  6  6  6  1  1  1
1  1  1  6  6  6  6  6  6  6  6  6  6  1  1  1  1  1  1  1  6  6  6  6  6  6  6  6  6  6  1  1  1  1  1  1  1  6  6  6  6  6  6  6  6  6  6  1  1  1  1  1  1  1  6  6  6  6  6  6  6  6  6  6  1  1  1
1  1  1  6  6  6  6  6  6  6  6  6  6  1  1  1  1  1  1  1  6  6  6  6  6  6  6  6  6  6  1  1  1  1  1  1  1  6  6  6  6  6  6  6  6  6  6  1  1  1  1  1  1  1  6  6  6  6  6  6  6  6  6  6  1  1  1
1  1  1 12  1  1  1  1  1  1  1  1  1  1  1  1  1  1  1  1  12 1  1  1  1  1  1  1  1  1  1  1  1  1  1  1  1 12  1  1  1  1  1  1  1  1  1  1  1  1  1  1  1  1 12  1  1  1  1  1  1  1  1  1  1  1  1
1  1  1  1  1  1  1  1  1  1  1  1  1  1  1  1  1  1  1  1  1  1  1  1  1  1  1  1  1  1  1  1  1  1  1  1  1  1  1  1  1  1  1  1  1  1  1  1  1  1  1  1  1  1  1  1  1  1  1  1  1  1  1  1  1  1  1
1  1  1  1  1  1  1  1  1  1  1  1  1  1  1  1  1  1  1  1  1  1  1  1  1  1  1  1  1  1  46 35 35 35 35 44 1  46 35 35 35 44 1  1  1  1  1  1  1  1  1  1  1  1  1  1  1  1  1  1  1  1  1  1  1  1  1
1  1  1  1  1  1  1  1  1  1  1  1  1  1  1  1  1  1  1  1  1  1  1  1  1  1  1  1  1  46 37 34 34 34 34 36 35 37 34 34 34 36 35 35 44 1  1  1  1  1  1  1  1  1  1  1  1  1  1  1  1  1  1  1  1  1  1
1  1  1  1  1  1  1  1  1  1  1  1  1  1  1  1  1  1  1  1  1  1  1  1  1  1  1  1  1  39 34 34 34 34 34 34 34 34 34 34 34 34 34 34 36 35 35 44 1  1  1  1  1  1  1  1  1  1  1  1  1  1  1  1  1  1  1
1  1  1  1  1  1  1  1  1  1  1  1  1  1  1  1  1  1  1  1  1  1  1  1  1  1  1  1  1  39 34 30 52 30 30 34 34 34 30 30 51 34 34 34 34 34 34 36 44 1  1  1  1  1  1  1  1  1  1  1  1  1  1  1  1  1  1
1  1  1  1  1  1  1  1  1  1  46 35 35 35 35 35 44 1  1  1  1  1  1  1  1  1  1  1  1  39 30 30 31 30 30 30 30 30 30 30 30 30 30 30 34 34 34 34 36 35 44 1  1  1  1  1  1  1  1  1  1  1  1  1  1  1  1
1  1  1  1  1  1  1  1  1  1  39 33 34 33 34 33 38 1  1  1  1  1  1  1  1  1  1  1  1  39 30 30 30 30 30 30 42 41 41 0  41 41 43 30 30 30 30 34 34 34 36 44 1  1  1  1  1  1  1  1  1  1  1  1  1  1  1
1  1  1  1  1  1  1  1  1  1  39 34 34 34 34 34 38 1  1  1  1  1  1  1  1  1  1  1  1  47 43 30 30 30 30 30 38 1  1  46 35 35 37 30 30 30 30 30 34 34 34 36 44 1  1  1  1  1  1  1  1  1  1  1  1  1  1
1  1  1  1  1  1  1  1  1  1  39 30 30 30 30 30 38 1  1  1  1  1  1  1  1  1  1  1  1  1  47 43 30 30 30 42 45 1  46 37 34 34 34 30 30 30 30 30 30 30 34 34 38 1  1  1  1  1  1  1  1  1  1  1  1  1  1
1  1  1  1  1  1  1  1  1  1  39 30 30 30 30 30 38 1  1  1  1  1  1  1  1  1  1  1  1  1  46 37 30 30 30 36 44 46 37 34 34 34 34 30 30 30 30 30 30 50 30 34 38 1  1  1  1  1  1  1  1  1  1  1  1  1  1
1  1  1  1  1  1  1  1  1  1  47 43 30 30 30 42 45 1  1  1  1  1  1  1  1  1  1  1  1  46 37 34 30 30 30 34 36 37 34 34 30 30 30 30 30 30 30 30 30 30 30 30 38 1  1  1  1  1  1  1  1  1  1  1  1  1  1
1  1  1  1  1  1  1  1  46 35 35 37 48 30 30 36 35 35 44 1  1  1  1  1  1  1  1  1  46 37 34 34 30 30 30 34 34 34 34 30 30 30 30 30 30 51 30 30 30 30 30 30 38 1  1  1  1  1  1  1  1  1  1  1  1  1  1
1  1  1  1  1  1  1  1  39 34 33 34 30 30 30 34 33 34 36 44 1  1  1  1  1  1  1  46 37 34 34 30 30 30 30 30 34 34 30 30 30 30 30 30 30 30 30 30 32 30 30 30 38 1  1  1  1  1  1  1  1  1  1  1  1  1  1
1  1  1  1  1  1  1  1  39 34 34 34 30 30 30 34 34 34 34 36 35 35 35 35 35 35 35 37 34 34 30 30 30 30 30 30 30 30 30 30 30 42 41 43 30 30 30 30 30 30 30 42 45 1  1  1  1  1  1  1  1  1  1  1  1  1  1
1  1  1  1  1  1  1  1  39 30 51 30 30 30 30 30 30 52 34 34 34 34 34 34 34 34 34 34 34 30 30 30 30 30 30 30 30 30 30 30 42 45 1  47 41 43 30 30 30 30 42 45 1  1  1  1  1  1  1  1  1  1  1  1  1  1  1
1  1  46 35 35 35 35 35 37 30 30 30 30 30 30 30 30 30 30 34 34 34 34 34 34 34 34 34 30 30 30 30 30 30 30 30 30 30 30 30 38 1  1  1  1  47 43 30 30 42 45 1  1  1  1  1  1  1  1  1  1  1  1  1  1  1  1
1  1  39 34 34 33 34 34 34 30 30 30 30 30 30 30 30 30 30 30 30 30 30 30 30 30 30 30 30 30 30 30 30 30 30 30 30 30 30 30 38 1  1  1  1  46 37 30 30 36 44 1  1  1  1  1  1  1  1  1  1  1  1  1  1  1  1
1  1  39 34 34 34 34 34 34 30 30 30 30 30 30 30 30 30 30 30 30 30 30 30 30 30 30 30 30 30 30 30 30 30 30 30 30 30 30 30 38 1  1  1  1  39 34 30 30 34 38 1  1  1  1  1  1  1  1  1  1  1  1  1  1  1  1
1  1  39 31 30 30 30 30 30 30 30 30 30 30 30 30 30 30 30 30 30 42 41 41 41 41 41 43 30 30 30 30 30 30 30 30 30 52 30 42 45 1  1  1  1  39 34 30 30 34 38 1  1  1  1  1  1  1  1  1  1  1  1  1  1  1  1
1  1  39 30 30 30 30 52 30 30 30 30 30 30 30 51 30 30 30 30 42 45 1  1  1  1  1  47 41 43 30 51 30 30 30 30 30 30 42 45 1  1  1  1  1  39 30 30 30 30 38 1  1  1  1  1  1  1  1  1  1  1  1  1  1  1  1
1  1  39 32 30 30 30 30 30 30 30 30 30 30 30 30 30 30 30 42 45 1  1  1  1  1  1  1  1  47 43 30 30 30 30 30 30 42 45 1  1  1  1  1  1  39 30 52 30 30 38 1  1  1  1  1  1  1  1  1  1  1  1  1  1  1  1
1  1  47 41 41 41 41 41 41 41 41 41 41 41 41 41 41 41 41 45 1  1  1  1  1  1  1  1  1  1  47 41 41 41 41 41 41 45 1  1  1  1  1  1  1  47 43 30 30 42 45 1  1  1  1  1  1  1  1  1  1  1  1  1  1  1  1
1  1  1  1  1  1  1  1  1  1  1  1  1  1  1  1  1  1  1  1  1  1  1  1  1  1  1  1  1  1  1  1  1  1  1  1  1  1  1  1  1  1  1  1  1  1  47 41 41 45 1  1  1  1  1  1  1  1  1  1  1  1  1  1  1  1  1
1  1  1  1  1  1  1  1  1  1  1  1  1  1  1  1  1  1  1  1  1  1  1  1  1  1  1  1  1  1  1  1  1  1  1  1  1  1  1  1  1  1  1  1  1  1  1  1  1  1  1  1  1  1  1  1  1  1  1  1  1  1  1  1  1  1  1
1  1  1  1  1  1  1  1  1  1  1  1  1  1  1  1  1  1  1  1  1  1  1  1  1  1  1  1  1  1  1  1  1  1  1  1  1  1  1  1  1  1  1  1  1  1  1  1  1  1  1  1  1  1  1  1  1  1  1  1  1  1  1  1  1  1  1
1  1  1  1  1  1  1  1  1  1  1  1  1  1  1  1  1  1  1  1  1  1  1  1  1  1  1  1  1  1  1  1  1  1  1  1  1  1  1  1  1  1  1  1  1  1  1  1  1  1  1  1  1  1  1  1  1  1  1  1  1  1  1  1  1  1  1
1  1  1  1  1  1  1  1  1  1  1  1  1  1  1  1  1  1  1  1  1  1  1  1  1  1  1  1  1  1  1  1  1  1  1  1  1  1  1  1  1  1  1  1  1  1  1  1  1  1  1  1  1  1  1  1  1  1  1  1  1  1  1  1  1  1  1